{
  "name": "Level 1",
  "grid": [
    [1, 1, 1, 1, 1, 1, 1, 1, 1, 1, 1, 1, 1, 1, 1, 1],
    [1, 0, 0, 0, 0, 0, 0, 0, 0, 0, 0, 0, 0, 0, 0, 1],
    [1, 0, 1, 1, 1, 0, 1, 1, 1, 0, 1, 1, 1, 0, 0, 1],
    [1, 0, 1, 0, 0, 0, 0, 0, 1, 0, 0, 0, 1, 0, 0, 1],
    [1, 0, 1, 0, 1, 1, 1, 0, 1, 1, 1, 0, 1, 1, 0, 1],
    [1, 0, 0, 0, 1, 0, 0, 0, 0, 0, 1, 0, 0, 1, 0, 1],
    [1, 0, 1, 0, 1, 0, 1, 1, 1, 0, 1, 1, 0, 1, 0, 1],
    [1, 0, 1, 0, 0, 0, 0, 0, 1, 0, 0, 0, 0, 0, 0, 1],
    [1, 0, 1, 1, 1, 2, 2, 0, 1, 0, 3, 3, 3, 1, 0, 1],
    [1, 0, 0, 0, 1, 2, 0, 0, 0, 0, 3, 0, 0, 1, 0, 1],
    [1, 0, 1, 0, 1, 2, 0, 1, 1, 0, 3, 0, 0, 1, 0, 1],
    [1, 0, 1, 0, 0, 0, 0, 1, 0, 0, 0, 0, 0, 1, 0, 1],
    [1, 0, 1, 1, 1, 1, 0, 1, 0, 1, 1, 1, 0, 1, 0, 1],
    [1, 0, 0, 0, 0, 0, 0, 1, 0, 0, 0, 0, 0, 0, 0, 1],
    [1, 0, 0, 0, 0, 0, 0, 0, 0, 0, 0, 0, 0, 0, 0, 1],
    [1, 1, 1, 1, 1, 1, 1, 1, 1, 1, 1, 1, 1, 1, 1, 1]
  ],
  "spawn": { "x": 1.5, "y": 1.5, "angle": 0.47123889803846897 },
  "entities": [
    { "type": "pickup_health", "x": 3.5, "y": 1.5, "radius": 0.28 },
    { "type": "pickup_ammo", "x": 12.5, "y": 1.5, "radius": 0.28 },
    { "type": "pickup_ammo", "x": 13.5, "y": 14.5, "radius": 0.28 },
    { "type": "pickup_health", "x": 1.5, "y": 14.5, "radius": 0.28 },
    { "type": "enemy_dummy", "x": 11.5, "y": 9.5, "radius": 0.34, "health": 45 },
    { "type": "enemy_dummy", "x": 6.5, "y": 12.5, "radius": 0.34, "health": 45 },
    { "type": "enemy_dummy", "x": 13.5, "y": 8.5, "radius": 0.34, "health": 45 },
    { "type": "exit", "x": 14.5, "y": 14.5, "radius": 0.45 }
  ]
}
