{
  "name": "Level 3",
  "grid": [
    [1, 1, 1, 1, 1, 1, 1, 1, 1, 1, 1, 1, 1, 1, 1, 1],
    [1, 0, 0, 0, 0, 0, 0, 0, 0, 0, 0, 0, 0, 0, 0, 1],
    [1, 0, 1, 1, 1, 1, 1, 0, 2, 2, 2, 0, 1, 1, 0, 1],
    [1, 0, 1, 0, 0, 0, 1, 0, 2, 0, 2, 0, 1, 0, 0, 1],
    [1, 0, 1, 0, 3, 0, 1, 0, 2, 0, 2, 0, 1, 0, 1, 1],
    [1, 0, 1, 0, 3, 0, 0, 0, 2, 0, 2, 0, 0, 0, 0, 1],
    [1, 0, 1, 0, 3, 3, 3, 0, 2, 0, 2, 0, 3, 3, 0, 1],
    [1, 0, 0, 0, 0, 0, 1, 0, 2, 0, 2, 0, 1, 0, 0, 1],
    [1, 0, 1, 1, 1, 0, 1, 0, 2, 0, 2, 0, 1, 0, 1, 1],
    [1, 0, 1, 0, 0, 0, 0, 0, 2, 0, 2, 0, 0, 0, 0, 1],
    [1, 0, 1, 0, 1, 1, 1, 1, 2, 2, 2, 1, 1, 1, 0, 1],
    [1, 0, 0, 0, 0, 0, 0, 0, 0, 0, 0, 0, 0, 1, 0, 1],
    [1, 0, 1, 1, 1, 1, 1, 1, 1, 1, 0, 1, 0, 1, 0, 1],
    [1, 0, 0, 0, 0, 0, 0, 0, 0, 1, 0, 1, 0, 0, 0, 1],
    [1, 0, 3, 3, 3, 3, 3, 0, 0, 1, 0, 0, 0, 3, 0, 1],
    [1, 1, 1, 1, 1, 1, 1, 1, 1, 1, 1, 1, 1, 1, 1, 1]
  ],
  "spawn": { "x": 14.5, "y": 14.5, "angle": 3.141592653589793 },
  "entities": [
    { "type": "pickup_health", "x": 13.5, "y": 13.5, "radius": 0.28 },
    { "type": "pickup_ammo", "x": 12.5, "y": 13.5, "radius": 0.28 },
    { "type": "pickup_ammo", "x": 8.5, "y": 2.5, "radius": 0.28 },
    { "type": "enemy_dummy", "x": 10.5, "y": 6.5, "radius": 0.34, "health": 75 },
    { "type": "enemy_dummy", "x": 6.5, "y": 9.5, "radius": 0.34, "health": 75 },
    { "type": "enemy_dummy", "x": 3.5, "y": 6.5, "radius": 0.34, "health": 75 },
    { "type": "enemy_dummy", "x": 8.5, "y": 11.5, "radius": 0.34, "health": 75 },
    { "type": "exit", "x": 1.5, "y": 1.5, "radius": 0.45 }
  ]
}
