{
  "name": "Level 2",
  "grid": [
    [1, 1, 1, 1, 1, 1, 1, 1, 1, 1, 1, 1, 1, 1, 1, 1],
    [1, 0, 0, 0, 0, 0, 0, 0, 0, 0, 0, 0, 0, 0, 0, 1],
    [1, 0, 2, 2, 2, 0, 0, 0, 0, 0, 0, 3, 3, 3, 0, 1],
    [1, 0, 2, 0, 0, 0, 1, 1, 1, 0, 0, 3, 0, 3, 0, 1],
    [1, 0, 2, 0, 1, 0, 0, 0, 1, 0, 0, 3, 0, 3, 0, 1],
    [1, 0, 2, 0, 1, 1, 1, 0, 1, 0, 0, 3, 0, 3, 0, 1],
    [1, 0, 0, 0, 0, 0, 1, 0, 1, 0, 0, 0, 0, 0, 0, 1],
    [1, 0, 1, 1, 1, 0, 1, 0, 1, 0, 1, 1, 1, 1, 0, 1],
    [1, 0, 1, 0, 0, 0, 0, 0, 0, 0, 0, 0, 0, 1, 0, 1],
    [1, 0, 1, 0, 1, 1, 1, 0, 1, 1, 1, 1, 0, 1, 0, 1],
    [1, 0, 1, 0, 0, 0, 1, 0, 0, 0, 0, 1, 0, 0, 0, 1],
    [1, 0, 1, 1, 1, 0, 1, 1, 1, 1, 0, 1, 1, 1, 0, 1],
    [1, 0, 0, 0, 1, 0, 0, 0, 0, 1, 0, 0, 0, 0, 0, 1],
    [1, 0, 3, 0, 1, 1, 1, 1, 0, 1, 1, 1, 1, 3, 0, 1],
    [1, 0, 3, 0, 0, 0, 0, 0, 0, 0, 0, 0, 0, 3, 0, 1],
    [1, 1, 1, 1, 1, 1, 1, 1, 1, 1, 1, 1, 1, 1, 1, 1]
  ],
  "spawn": { "x": 1.5, "y": 1.5, "angle": 0.0 },
  "entities": [
    { "type": "pickup_ammo", "x": 4.5, "y": 2.5, "radius": 0.28 },
    { "type": "pickup_health", "x": 12.5, "y": 2.5, "radius": 0.28 },
    { "type": "pickup_ammo", "x": 13.5, "y": 14.5, "radius": 0.28 },
    { "type": "enemy_dummy", "x": 8.5, "y": 8.5, "radius": 0.34, "health": 60 },
    { "type": "enemy_dummy", "x": 10.5, "y": 10.5, "radius": 0.34, "health": 60 },
    { "type": "enemy_dummy", "x": 5.5, "y": 12.5, "radius": 0.34, "health": 60 },
    { "type": "exit", "x": 14.5, "y": 1.5, "radius": 0.45 }
  ]
}
